1111111111
100C0E00P1
1111111110