11111111
10000001
1000C0C1
10E000P1
11111111