11111111
100EC001
10P00PL1
11111111